Map-1 
                      #  #  #      
                       ##         
 *                   #%#          
&                       ## ##     
      &               %#  ##      
      &               ## % #      
       &              #   # #     
                      %      %    
   &*   & &                       
&                        #  ####  
                          ###     
 &                 #     %   #   #
                ##  # ## #     #  
                   #       #  #   
       &           # #   # ## # # 
                # #  # # %#  ### #
                           #  # # 
                ##  % ##    #   ##
                   #  ##          
         &         %   %          
   &               *&     &   &   
                    &   &     & * 
                               *&&
           *&*                    
     &                            
                                  
                               &  
         &    &*    &             
                   &        &     
                        &    & &  
                              *   
   & && &                     *   
                             &  &&
                      &  &        
