Map-2 
                                   
                       &       &  
                           &      
                                  
         &                        
   *   &  *     &    &            
   &                          *   
               &   *         &    
                   &              
           &                      
     *& &   &         &           
        &     &   &           &   
                                  
      &      & &   &&&  & &       
                     *  *         
               *                  
         *      &      #  #       
        & &        &   %# #    #  
                        # %##  #  
                          ##  %#  
            &*  &      #  #       
               &&&      #  #   #  
            &          # ##  ##   
                       ## ##  ##  
                &     %    # #%   
             &                    
      #    #             #        
    #    ###                ###   
    ##                    %# # %  
       #   #                  ## %
   %   ##                   #   # 
    ###  # #                #%#   
    #  #                 #  # ### 
       #                  ##   #  
